{
  "bpm": 70,
  "width": 9,
  "height": 11,
  "groundblock": [

    [ 0, 0, 0, 0, 0, 0, 0, 0, 0 ],
    [ 0, 0, 0, 0, 0, 0, 0, 0, 0 ],
    [ 0, 0, 0, 0, 0, 0, 0, 0, 0 ],
    [ 0, 0, 0, 0, 0, 0, 0, 0, 0 ],
    [ 0, 0, 0, 0, 0, 0, 0, 0, 0 ],
    [ 0, 0, 1, 0, 0, 0, 0, 0, 0 ],
    [ 0, 0, 1, 0, 0, 0, 0, 0, 0 ],
    [ 1, 0, 1, 1, 0, 0, 0, 1, 0 ],
    [ 1, 0, 0, 1, 0, 0, 0, 1, 1 ],
    [ 1, 0, 0, 1, 0, 1, 0, 1, 1 ],
    [ 0, 0, 1, 0, 0, 1, 0, 0, 1 ],
    [ 0, 0, 1, 0, 0, 1, 0, 0, 0 ],
    [ 0, 0, 1, 0, 1, 0, 0, 1, 0 ],
    [ 1, 0, 0, 0, 1, 0, 0, 1, 0 ],
    [ 1, 1, 0, 0, 1, 0, 0, 1, 0 ],
    [ 1, 1, 0, 0, 0, 0, 0, 0, 0 ],
    [ 0, 1, 0, 0, 0, 0, 0, 0, 0 ],
    [ 0, 0, 0, 1, 0, 0, 1, 0, 0 ],
    [ 0, 0, 0, 1, 0, 0, 1, 0, 0 ],
    [ 0, 0, 0, 1, 0, 0, 1, 0, 0 ]
  ],
  "animation": [],
  "teleportation": [

    {
      startPos: {
        x: 8,
        y: 1
      },
      endPos: {
        x: 0,
        y: 0
      }
    }
  ],
  "laser": [
    {
      pos: 3,
      side: 1,
      appearTime: 3
    }
  ]}