{
  "GameVersion":"1.0.0",
  "bpm": 70,
"blockData": [
  {
    "type": "drop",
    "tiles":["null","flame"],
    "matrix": [
      [ 0, 0, 0, 0, 0, 0, 0, 0, 0 ],
      [ 0, 0, 0, 0, 0, 0, 0, 0, 0 ],
      [ 0, 0, 0, 0, 0, 0, 0, 0, 0 ],
      [ 0, 0, 0, 0, 0, 0, 0, 0, 0 ],
      [ 0, 0, 0, 0, 0, 0, 0, 0, 0 ],
      [ 0, 0, 1, 0, 0, 0, 0, 0, 0 ],
      [ 0, 0, 1, 0, 0, 0, 0, 0, 0 ],
      [ 1, 0, 1, 1, 0, 0, 0, 1, 0 ],
      [ 1, 0, 0, 1, 0, 0, 0, 1, 1 ],
      [ 1, 0, 0, 1, 0, 1, 0, 1, 1 ],
      [ 0, 0, 1, 0, 0, 1, 0, 0, 1 ],
      [ 0, 0, 1, 0, 0, 1, 0, 0, 0 ],
      [ 0, 0, 1, 0, 1, 0, 0, 1, 0 ],
      [ 1, 0, 0, 0, 1, 0, 0, 1, 0 ],
      [ 1, 1, 0, 0, 1, 0, 0, 1, 0 ],
      [ 1, 1, 0, 0, 0, 0, 0, 0, 0 ],
      [ 0, 1, 0, 0, 0, 0, 0, 0, 0 ],
      [ 0, 0, 0, 1, 0, 0, 1, 0, 0 ],
      [ 0, 0, 0, 1, 0, 0, 1, 0, 0 ],
      [ 0, 0, 0, 1, 0, 0, 1, 0, 0 ]
    ]
  },
  {"type": "animation",
    "appearTime":4,
    "tiles":["null","flame"],
    "frame":[
      [[0,0,0],[0,1,0],[0,0,0]],
      [[0,1,0],[1,1,1],[0,1,0]],
      [[1,1,1],[1,1,1],[1,1,1]]
    ]},
  {"type": "teleportation",
    "tiles":["null","flame"],
    "startPos": {
      "x": 8,
      "y": 1
    },
    "endPos": {
      "x": 0,
      "y": 0
    }},
  {
    "type": "laser",
    "tiles":["null","flame"],
    "pos": 3,
    "side": 1,
    "appearTime": 3
  }
]}